***************
** #          *
*             *
*    *        *
*    *  %     *
*    *        *
* ****      % *
*             *
*    ****     *
* *  *   *    *
*          %  *
*   %         *
*             *
***************
